ba	bb	ba	ba
beng	bd	bg	bg
bei	bf	bz	bw
ben	bg	bf	bf
bai	bh	bl	bd
bie	bj	bx	bp
bang	bk	bh	bh
ban	bl	bj	bj
bi	by	bi	bi
bing	bn	by	bk
bo	bw	bo	bo
biao	bq	bc	bn
bin	bs	bn	bb
bao	bt	bk	bc
bu	bv	bu	bu
bian	bx	bm	bm
a	vb	va	va
ca	cb	ca	ca
cun	cc	cp	cy
ceng	cd	cg	cg
cen	cg	cf	cf
cai	ch	cl	cd
cang	ck	ch	ch
can	cl	cj	cj
ci	cy	ci	ci
ce	cp	ce	ce
cong	cr	cs	cs
cui	cs	cv	cv
cao	ct	ck	cc
cu	cv	cu	cu
cou	cm	cb	cz
cuo	cw	co	co
wen	wg	wf	wf
cuan	cz	cr	cr
da	db	da	da
dun	dc	dp	dy
deng	dd	dg	dg
dei	df	dz	dw
diu	dg	dq	dq
dai	dh	dl	dd
die	dj	dx	dp
dang	dk	dh	dh
dan	dl	dj	dj
di	dy	di	di
ding	dn	dy	dk
de	dp	de	de
diao	dq	dc	dn
dong	dr	ds	ds
dui	ds	dv	dv
dao	dt	dk	dc
du	dv	du	du
dou	dm	db	dz
duo	dw	do	do
dian	dx	dm	dm
dia	db	dw	dx
duan	dz	dr	dr
fa	fb	fa	fa
feng	fd	fg	fg
fei	ff	fz	fw
fen	fg	ff	ff
fang	fk	fh	fh
fan	fl	fj	fj
fo	fw	fo	fo
fu	fv	fu	fu
fou	fm	fb	fz
ga	gb	ga	ga
gun	gc	gp	gy
geng	gd	gg	gg
gei	gf	gz	gw
gen	gg	gf	gf
gai	gh	gl	gd
gua	gj	gw	gx
gang	gk	gh	gh
gan	gl	gj	gj
ge	gp	ge	ge
guai	gq	gy	gk
gong	gr	gs	gs
gui	gs	gv	gv
gao	gt	gk	gc
gu	gv	gu	gu
gou	gm	gb	gz
guo	gw	go	go
guang	gx	gd	gl
en	vg	vf	vf
guan	gz	gr	gr
ha	hb	ha	ha
hun	hc	hp	hy
heng	hd	hg	hg
hei	hf	hz	hw
hen	hg	hf	hf
hai	hh	hl	hd
hua	hj	hw	hx
hang	hk	hh	hh
han	hl	hj	hj
he	hp	he	he
huai	hq	hy	hk
hong	hr	hs	hs
hui	hs	hv	hv
hao	ht	hk	hc
hu	hv	hu	hu
hou	hm	hb	hz
huo	hw	ho	ho
huang	hx	hd	hl
ai	vh	vl	vd
huan	hz	hr	hr
jia	jb	jw	jx
jun	jc	jp	jy
jiu	jg	jq	jq
jie	jj	jx	jp
jiang	jk	jd	jl
ji	jy	ji	ji
jing	jn	jy	jk
jiao	jq	jc	jn
jiong	jr	js	js
jin	js	jn	jb
ju	jv	ju	ju
jue	jp	jt	jt
jian	jx	jm	jm
wa	wb	wa	wa
juan	jz	jr	jr
ka	kb	ka	ka
kun	kc	kp	ky
keng	kd	kg	kg
ken	kg	kf	kf
kai	kh	kl	kd
kua	kj	kw	kx
kang	kk	kh	kh
kan	kl	kj	kj
ke	kp	ke	ke
kuai	kq	ky	kk
kong	kr	ks	ks
kui	ks	kv	kv
kao	kt	kk	kc
ku	kv	ku	ku
kou	km	kb	kz
kuo	kw	ko	ko
kuang	kx	kd	kl
ang	vk	vh	vh
kuan	kz	kr	kr
la	lb	la	la
lun	lc	lp	ly
leng	ld	lg	lg
lei	lf	lz	lw
liu	lg	lq	lq
lai	lh	ll	ld
lie	lj	lx	lp
lang	lk	lh	lh
lan	ll	lj	lj
li	ly	li	li
ling	ln	ly	lk
le	lp	le	le
liao	lq	lc	ln
long	lr	ls	ls
lin	ls	ln	lb
lao	lt	lk	lc
lu	lv	lu	lu
lou	lm	lb	lz
luo	lw	lo	lo
lian	lx	lm	lm
an	vl	vj	vj
lia	lb	lw	lx
liang	lk	ld	ll
lv	lv	lv	lv
lue	lp	lt	lt
luan	lz	lr	lr
ma	mb	ma	ma
meng	md	mg	mg
mei	mf	mz	mw
men	mg	mf	mf
mai	mh	ml	md
mie	mj	mx	mp
mang	mk	mh	mh
man	ml	mj	mj
mi	my	mi	mi
ming	mn	my	mk
me	mp	me	me
miao	mq	mc	mn
min	ms	mn	mb
mao	mt	mk	mc
mu	mv	mu	mu
mou	mm	mb	mz
mian	mx	mm	mm
m	mv	mv	mv
miu	mg	mq	mq
na	nb	na	na
neng	nd	ng	ng
nei	nf	nz	nw
nen	ng	nf	nf
nai	nh	nl	nd
nie	nj	nx	np
nang	nk	nh	nh
nan	nl	nj	nj
ni	ny	ni	ni
ning	nn	ny	nk
ne	np	ne	ne
niao	nq	nc	nn
nong	nr	ns	ns
nin	ns	nn	nb
nao	nt	nk	nc
nu	nv	nu	nu
nou	nm	nb	nz
nuo	nw	no	no
nian	nx	nm	nm
n	nv	nv	nv
niu	ng	nq	nq
niang	nk	nd	nl
nv	nv	nv	nv
nue	np	nt	nt
nuan	nz	nr	nr
pa	pb	pa	pa
peng	pd	pg	pg
pei	pf	pz	pw
pen	pg	pf	pf
pai	ph	pl	pd
pie	pj	px	pp
pang	pk	ph	ph
pan	pl	pj	pj
pi	py	pi	pi
ping	pn	py	pk
po	pw	po	po
piao	pq	pc	pn
pin	ps	pn	pb
pao	pt	pk	pc
pu	pv	pu	pu
pou	pm	pb	pz
pian	px	pm	pm
o	vw	vo	vo
qia	qb	qw	qx
qun	qc	qp	qy
qiu	qg	qq	qq
qie	qj	qx	qp
qiang	qk	qd	ql
qi	qy	qi	qi
qing	qn	qy	qk
qiao	qq	qc	qn
qiong	qr	qs	qs
qin	qs	qn	qb
qu	qv	qu	qu
que	qp	qt	qt
qian	qx	qm	qm
wai	wh	wl	wd
quan	qz	qr	qr
run	rc	rp	ry
reng	rd	rg	rg
ren	rg	rf	rf
rang	rk	rh	rh
ran	rl	rj	rj
ri	ry	ri	ri
re	rp	re	re
rong	rr	rs	rs
rui	rs	rv	rv
rao	rt	rk	rc
ru	rv	ru	ru
rou	rm	rb	rz
ruo	rw	ro	ro
ruan	rz	rr	rr
sa	sb	sa	sa
sun	sc	sp	sy
seng	sd	sg	sg
sen	sg	sf	sf
sai	sh	sl	sd
sang	sk	sh	sh
san	sl	sj	sj
si	sy	si	si
se	sp	se	se
song	sr	ss	ss
sui	ss	sv	sv
sao	st	sk	sc
su	sv	su	su
sou	sm	sb	sz
suo	sw	so	so
wei	wf	wz	ww
suan	sz	sr	sr
ta	tb	ta	ta
tun	tc	tp	ty
teng	td	tg	tg
tei	tf	tz	tw
tai	th	tl	td
tie	tj	tx	tp
tang	tk	th	th
tan	tl	tj	tj
ti	ty	ti	ti
ting	tn	ty	tk
te	tp	te	te
tiao	tq	tc	tn
tong	tr	ts	ts
tui	ts	tv	tv
tao	tt	tk	tc
tu	tv	tu	tu
tou	tm	tb	tz
tuo	tw	to	to
tian	tx	tm	tm
ao	vt	vk	vc
tuan	tz	tr	tr
zha	zb	za	za
zhun	zc	zp	zy
zheng	zd	zg	zg
zhei	zf	zz	zw
zhen	zg	zf	zf
zhai	zh	zl	zd
zhua	zj	zw	zx
zhang	zk	zh	zh
zhan	zl	zj	zj
zhi	zy	zi	zi
zhe	zp	ze	ze
zhuai	zq	zy	zk
zhong	zr	zs	zs
zhui	zs	zv	zv
zhao	zt	zk	zc
zhu	zv	zu	zu
zhou	zm	zb	zz
zhuo	zw	zo	zo
zhuang	zx	zd	zl
wu	wv	wu	wu
zhuan	zz	zr	zr
cha	cb	ca	ca
chun	cc	cp	cy
cheng	cd	cg	cg
chen	cg	cf	cf
chai	ch	cl	cd
chang	ck	ch	ch
chan	cl	cj	cj
chi	cy	ci	ci
che	cp	ce	ce
chuai	cq	cy	ck
chong	cr	cs	cs
chui	cs	cv	cv
chao	ct	ck	cc
chu	cv	cu	cu
chou	cm	cb	cz
chuo	cw	co	co
chuang	cx	cd	cl
ou	vm	vb	vz
chuan	cz	cr	cr
sha	sb	sa	sa
shun	sc	sp	sy
sheng	sd	sg	sg
shei	sf	sz	sw
shen	sg	sf	sf
shai	sh	sl	sd
shua	sj	sw	sx
shang	sk	sh	sh
shan	sl	sj	sj
shi	sy	si	si
she	sp	se	se
shuai	sq	sy	sk
shui	ss	sv	sv
shao	st	sk	sc
shu	sv	su	su
shou	sm	sb	sz
shuo	sw	so	so
shuang	sx	sd	sl
wo	ww	wo	wo
shuan	sz	sr	sr
xia	xb	xw	xx
xun	xc	xp	xy
xiu	xg	xq	xq
xie	xj	xx	xp
xiang	xk	xd	xl
xi	xy	xi	xi
xing	xn	xy	xk
xiao	xq	xc	xn
xiong	xr	xs	xs
xin	xs	xn	xb
xu	xv	xu	xu
xue	xp	xt	xt
xian	xx	xm	xm
wang	wk	wh	wh
xuan	xz	xr	xr
ya	yb	ya	ya
yun	yc	yp	yy
weng	wd	wg	wg
ea	vp	ve	ve
you	ym	yb	yz
ye	yp	ye	ye
yang	yk	yh	yh
er	vl	vr	vr
yi	yy	yi	yi
ying	yn	yy	yk
e	vp	ve	ve
yong	yr	ys	ys
yin	ys	yn	yb
yu	yv	yu	yu
yue	yp	yt	yt
yan	yl	yj	yj
yuan	yz	yr	yr
za	zb	za	za
zun	zc	zp	zy
zeng	zd	zg	zg
zei	zf	zz	zw
zen	zg	zf	zf
zai	zh	zl	zd
zang	zk	zh	zh
zan	zl	zj	zj
zi	zy	zi	zi
ze	zp	ze	ze
zong	zr	zs	zs
zui	zs	zv	zv
zao	zt	zk	zc
zu	zv	zu	zu
zou	zm	zb	zz
zuo	zw	zo	zo
wan	wl	wj	wj
zuan	zz	zr	zr
yao	yt	yk	yc
mo	mw	mo	mo
ei	vf	vz	vw
yo	yw	yo	yo
lve	lp	lt	lt
nve	np	nt	nt